WWWWWWWWWWWWWWWWWWWW
WOOOOOOOOOOOOOOOOOOW
WOOOOOOOOOOOOOOOOOOW
WOOOOOOOOOOOOOOOOOOW
WOOOOOOOOOOOOOOOOOOW
WOOOOOOOOOOOOOOOOOSW
WOOOWOWOWWWOWCCCOCCW
WOOOOWOWOOOWOOOWOOOW
WOOOOOOOOOOOOOOCOOOW
WOOOOOOOOOOOOOSWOOOW
WOOOOOOOOOOOOOOWOOOW
WOOOOOOWWCOCWWOCOOOW
WOOOOOOOOOOOOCOCOOOW
WOOOOOOOOOOOOWWWOOOW
WSOOOOOOOOOOOOOOOOOW
WOOOOOOOOOOOOOOOOOOW
WOOOOOOOOOOOOOOOOOOW
WOOOOOOOOOOOOOOOOOOW
WOOOOOOOOOOOOOOOOOSW
WWWWWWWWWWWWWWWWWWWW