WWWWWWWWWWWWWWWWWWWW
WOOOOOOOOOOOOOOOOOOW
WOOOOOOOOOOOOOOOOOOW
WOOOOOOOOOOOOOOOOOOW
WOOOOOOOOOOOOOOOOOOW
WOOOOOOOOOOOOOOOOOOW
WOOOWOWOWWWOWCCCOCCW
WOOOOWOWOOOWOOOWOOOW
WOOOOOOOOOOOOOOCOOOW
WOOOOOOOOOOOOOOWOOOW
WOOOOOOOOOOOOOOWOOOW
WOOOOOOWWCOCWWOCOOOW
WOOOOOOOOOOOOCOCOOOW
WOOOOOOOOOOOOWWWOOOW
WOOOOOOOOOOOOOOOOOOW
WOOOOOOOOOOOOOOOOOOW
WOOOOOOOOOOOOOOOOOOW
WOOOOOOOOOOOOOOOOOOW
WOOOOOOOOOOOOOOOOOOW
WWWWWWWWWWWWWWWWWWWW